XXX XXX
XXX XXX
XXX XXX
XXX XXX
XXX XXXX XX X XX XXX
XXX XXXX XX X XX XXX
XXXX
XXXX XX XX
XXX XX X
XXXX XXX XXXX XXX XXXX

PASS .grid 1 
PASS .grid 2 
PASS .grid 3 
PASS .grid 4 
PASS .grid 5 
PASS .grid 6 
PASS .grid 7 

