Test that resolving auto tracks on grid items works properly.

XXXXX
PASS
XXXXX
PASS
XXXXX
PASS
XXXXX XXXX
XXXXX XXXX
PASS
XXXXX XXXX
XXXXX XXXX
PASS
XXXXX XXXX
XXXXX XXXX
PASS
XXXXX XXXXX XXXXX XXXXX
PASS
XXXXX XXXXX XXXXX XXXXX XXXXX
XXXXX XXXXX XXXXX XXXXX XXXXX XXXXX
PASS
XXXXX XXXXX XXXXX XXXXX
XXXXX XXXXX XXXXX XXXXX XXXXX XXXXX
PASS
XXXXX XXXXX XXXXX XXXXX
XXXXX XXXXX XXXXX XXXXX XXXXX XXXXX
PASS
XXXXX XXXXX XXXXX XXXXX
XXXXX XXXXX XXXXX XXXXX XXXXX XXXXX
PASS
