PASS successfullyParsed is true

TEST COMPLETE
PASS
PASS
PASS
PASS
XXXX XXXX
XXX XXX
XXXXX XXXXX
XX XX XX XX
PASS
XXXXX
XXX XXX XXX
XXXX XXXX
PASS
XX
XXX XXX XXX
XXXX XXXX
PASS
